>.#########
..........#
###.###.###
#.#.#.....#
#.#.#######
#...#...#.#
###.###.#.#
#.........#
#####.###.#
#.......#..
#########.$