.#.########
#.#...#...#
#.#.###.#.#
#..>#...#.#
#.#####.#.#
#.....#.#.#
#.#####.#.#
#.......#.#
#.###.#.###
#...#.#....
#########.$