>.#########
......#...#
#.###.#.#.#
#...#...#.#
#.###.#####
#.#...#...#
#.#####.#.#
#.......#.#
#.#######.#
#.#........
#########.$