>..........
...........
...........
..#######..
..#######..
..#######..
..#######..
..#######..
...........
...........
..........$