...........
.....#.....
.....#.....
.....#.....
.....#.....
..>..#..$..
.....#.....
.....#.....
.....#.....
.....#.....
...........